4 1 2 3 4 4
1 0 X 0 0 3
2 0 0 0 3 3
3 0 3 0 0 3
4 4 4 4 4 4